0 5 6 11 14 19 22 24 26 28 30 32 34 36 38 
1 5 6 11 14 19 22 24 26 28 30 32 34 36 38 
3 6 8 10 11 14 16 18 19 22 28 30 36 38 
5 0 1 8 10 11 14 16 18 19 22 24 26 28 30 32 34 36 38 
6 0 1 3 8 10 11 14 16 18 19 22 24 26 28 30 32 34 36 38 
8 3 5 6 11 14 16 18 19 22 24 26 28 30 32 34 36 38 
10 1 3 5 6 14 16 18 19 22 24 26 28 30 32 34 36 38 
11 0 1 3 5 6 8 16 18 19 22 24 26 28 30 32 34 36 38 
14 0 1 3 5 6 8 10 16 18 19 22 24 26 28 30 32 34 36 38 
16 3 5 6 8 10 11 14 19 22 24 26 28 30 32 34 36 38 
18 1 3 5 6 8 10 11 14 22 24 26 28 30 32 34 36 38 
19 0 1 3 5 6 8 10 11 14 16 24 26 28 30 32 34 36 38 
22 0 1 3 5 6 8 10 11 14 16 18 24 26 28 30 32 34 36 38 
24 0 1 5 6 8 10 11 14 16 18 19 22 28 30 32 34 36 38 
26 0 1 5 6 8 10 11 14 16 18 19 22 30 32 34 36 38 
28 0 1 3 5 6 8 10 11 14 16 18 19 22 24 32 34 36 38 
30 0 1 3 5 6 8 10 11 14 16 18 19 22 24 26 32 34 36 38 
32 0 1 5 6 8 10 11 14 16 18 19 22 24 26 28 30 36 38 
34 0 1 5 6 8 10 11 14 16 18 19 22 24 26 28 30 38 
36 0 1 3 5 6 8 10 11 14 16 18 19 22 24 26 28 30 32 
38 0 1 3 5 6 8 10 11 14 16 18 19 22 24 26 28 30 32 34 
